1111111111111111111111
1E00000000000C00000001
1110010100010011100001
1010010010011000100001
100000000001C000110111
10000P0000010000010001
1000000000010000010001
1000010000010000010001
100001000001C0000000C1
1000010000010000010001
1111111111111111111111