1111111111111111111111
1E00010000000C000C0001
11100101000100111000C1
10100100100110001000C1
100C01000001C000111111
100C00000011C000111111
100C000000010000110001
100C01000001CCCC010001
100C01000001C0000000C1
1P0001000001000B010001
1111111111111111111111